
NO 1.png
SO 1.png
EA 1.png
WE 1.png
C 255,200,255
F 122,122,122

1111111111111
    1N1
     1






