NO ./path_to_the_north_texture
SO ./path_to_the_south_texture
WE ./path_to_the_west_texture
C 123,255,255
EA ./path_to_the_east_texture
F 220,100,0




111111111
10000001111
1000000111
1000000111
1000000111
1000000111
1000000111        11
1000S0011111111111001
10111110111111111101                      1   1
1001  101         1                          101             111
 11    11                                     1              1001
1111                                         1111          11111
